1 1 1 1 0 0 0 1 1 1 0 0 0 0 1 1 1 1 1 1 1 1 1 1
1 1 1 1 0 0 0 1 1 1 0 0 0 1 1 1 1 1 1 1 1 1 1 1
1 1 1 1 0 0 0 1 1 1 0 0 0 1 2 2 9 2 2 3 2 2 2 1
1 1 0 1 0 0 0 1 1 1 0 0 0 1 2 1 1 1 2 1 1 1 2 1
1 1 0 1 0 0 0 1 1 1 0 0 0 1 2 1 1 1 2 1 1 1 2 1
1 1 1 1 1 1 1 1 1 1 1 1 1 1 2 1 1 2 2 1 1 1 2 1
1 1 1 1 0 1 1 1 0 1 1 1 1 2 2 2 2 2 1 1 1 1 2 1
1 1 1 1 1 1 1 1 0 1 1 1 1 2 1 1 1 2 1 1 1 1 2 1
1 1 0 1 1 1 1 1 0 1 1 1 1 2 1 1 1 2 1 1 1 1 2 1
1 1 0 1 1 0 0 0 0 0 0 0 0 0 1 1 1 2 1 1 1 1 2 1
1 1 0 1 1 0 1 1 1 1 1 0 1 1 1 1 1 2 1 1 1 1 2 1
1 1 1 1 1 0 1 0 8 0 1 0 1 1 1 1 1 2 1 1 1 1 2 1
1 1 1 1 0 0 1 0 0 0 1 0 1 1 1 1 1 2 1 1 1 1 2 1
1 1 1 1 1 5 1 0 6 0 1 4 1 1 1 1 1 0 1 1 1 1 2 1
1 1 1 1 1 0 1 0 0 0 1 0 1 1 1 1 1 0 1 1 1 1 2 1
1 1 1 0 0 0 1 0 0 0 1 0 2 2 2 2 2 2 2 2 1 1 2 1
1 1 1 1 1 0 1 0 7 0 1 0 1 1 1 1 2 1 1 2 1 1 2 1
1 1 0 1 1 0 1 1 1 1 1 0 1 1 1 1 2 1 1 2 1 1 2 1
1 1 0 1 1 0 0 0 0 0 0 0 0 0 2 2 2 1 1 2 1 1 2 1
1 1 0 1 1 1 1 1 0 1 1 1 1 1 1 2 1 1 1 2 1 1 2 1
1 1 1 1 1 1 1 1 0 1 1 1 1 1 1 2 1 1 1 2 2 2 2 1
1 1 1 1 1 1 1 1 1 1 1 1 1 1 1 2 1 1 1 1 1 1 2 1
1 1 1 1 1 1 1 1 1 1 1 1 1 1 1 2 1 1 1 1 1 1 2 1
1 1 0 1 0 0 0 1 1 1 0 0 0 1 1 2 1 1 1 1 1 1 2 1
1 1 0 1 0 0 0 1 1 1 0 0 0 1 1 2 1 1 1 1 1 1 2 1
1 1 1 1 0 0 0 1 1 1 0 0 0 1 1 2 2 2 2 2 3 2 2 1
1 1 1 1 0 0 0 1 1 1 0 0 0 1 1 1 1 1 1 1 1 1 1 1
1 1 1 1 0 0 0 1 1 1 0 0 0 1 1 1 1 1 1 1 1 1 1 1